############################
#..........................#
#..........................#
#..........................#
............................
............................
..........#....Z............
..........#.................
############################