###############################################
#.............................................#
#.............................................#
#.............................................#
#.............................................#
#.............................................#
#.............................................#
#.....................######..................#
#.............................................#
...Z.....######...........................D....
.............................#######...........
...............................................
...............................................
###############################################