########################################################
#......................................................#
#......................................................#
#......................................................#
#......................................................#
#.............................................##.......#
#............###..............................##.......#
#.............................................##.......#
#........................................###..##.......#
#.........................######..............##.......#
#....#####....................................##.......#
#.............................................##.......#
..............................................##........
..............................................##........
.........####.................................##........
..............................................##........
########################################################