#####################################################
#...................................................#
#...................................................#
#...................................................#
#...................................................#
#..........................................##.......#
#............###...........................##.......#
#..........................................##.......#
#.....................................###..##.......#
#........................######............##.......#
#....#####.................................##.......#
#..........................................##.......#
...........................................##........
...........................................##........
.........####..............................##........
...........................................##........
#####################################################