##################################################
#........................#.......................#
#........................#.......................#
#........................#.......................#
#........................#.......................#
#........................#.......................#
#........................#.......................#
#................#.......#.......................#
#................#.......#......#................#
#....####........#.......###....#................#
#................#..............#................#
#................#..............#................#
.................#..............#.................
...........####..#............###.................
.................#..............#.................
......S..I.......#....O.........#.........C.......
##################################################