#############################################
#...........................................#
#...........................................#
#..................O........................#
#...........................................#
#...........................................#
#.............#######........#..............#
#.................###.......................#
#...####..........###.......................#
#.................###.......................#
...........S......###........................
..................###..............#.........
.........#####....###..............#.........
..................###....I.....I...#.........
#############################################