#####################################################
#...................................................#
#...................................................#
#...................................................#
#...................................................#
#...................................................#
#...................................................#
#....................................#..............#
#.........................####.......#..............#
.....................................#...............
..............###....................#...............
.....................................#...............
..............I..............S.......#...D...........
#####################################################