#####################################################
#...................................................#
#...................................................#
#...................................................#
#...................................................#
#...................................................#
#...................................................#
#....................................#..............#
#.........................####.......#..............#
.....................................#...............
..............###....................#...............
.....................................#...............
..............I.............SS.......#...D...........
#####################################################