#############
#............
#............
#............
#...@........
#############