#############
#............
#............
#...@........
#............
#############