#############
d...........#
............#
............#
.....P......#
#############