#############
............#
............#
............#
.....P......#
#############