#################
#@..............#
#...............#
#...............#
#################