###############################################
#.............................................#
#.......................e.....................#
#.............................................#
#.....................######..................#
#.............................................#
#.........######..............................#
#........................@.....#######........#
#.............................................#
#.............................................#
###############################################