#################
#...............#
#...............#
#...............#
#...............#
#...............#
#.........#######
#..@............#
#...............#
#...............#
#################