###############################################
#.............................................#
#......................e......................#
#.............................................#
#.....................######..................#
#.............................................#
#.........######..............................#
#..@...........................#######........#
#.............................................#
#.............................................#
###############################################