########################################################
#......................................................#
#......................................................#
#......................................................#
#......................................................#
#....................................######............#
#......................................................#
#................#######...............................#
#......................................................#
#......................................................#
#....................................######.G..........#
#............#######...................................#
#......................................................#
#.............................................###......#
#......................................................#
.........#######........................................
......................................######............
........................................................
........................................................
########################################################